11111111
100000P1
10000EC1
11111111