111111111111111
1P0000000010001
101111111101111
100000C000000E1
101110111110101
1C0001000000001
101011101111101
100010001000001
111011101011101
1C00000000000C1
101111111111101
111111111111111
