11111111111111
1E000000000001
10000111110001
10001111110001
100000111100C1
1P000011110001
100C0011110001
10000011110001
10000011110001
10000011110001
10000011110001
10000011110001
11111111111111
