11111111111111
1E1010C0000001
10000P001001C1
11111111111111