1111111111111111111111111
1000000000000000000000001
10000000000000000000000E1
10000000000C0000000000001
1000000000000000000000001
10000C000000000000C000001
1000000000000000000000001
100000000000P000000000001
1111111111111111111111111