11111111111111111111
10000000000000000001
10000010000111110001
10000100000000010001
10000100000000010001
10001000000111110001
10010010000100000001
10011111000100000001
10000010000111110001
10000010000000000001
1PCE0000000000000001
11111111111111111111
