111111111111111
1P00000100000E1
101110101110101
100010000010001
101011101011101
100000C00000001
101011101110101
1C00100010001C1
101110101110101
111111111111111
