1111111
1P000E1
1011101
1000001
1C111C1
1111111
