1111111111
1P000001E1
1110111101
1C00000001
1011111101
1000000001
1C111111C1
1111111111
