111111111111
1P0000000001
101111111101
1C00000000E1
101110111101
100010000001
101010111101
1C00010000C1
101111111101
111111111111
